
XXXXXXXXXXXX
X___X______X
__X_X_XXXX_X
XXX_X____X_X
X____XXX_X__
XXXX_X_X_X_X
X__X_X_X_X_X
XX_X_X_X_X_X
X________X_X
XXXXXX_XXX_X
X______X___X
XXXXXXXXXXXX