
XXXXXXXXXXXX
X___X___XX__
X_X___X____X
X_XXXX_X_X_X
X___XX_____X
XXX_XXXX_X_X
__________XX
XXXXXXXXXXXX