
XXXXXXXXXXXXXXXXXXX
__________________X
X_XXXXXXXXXXXXXXXXX
X_____________X___X
X_XXX_XXXXX_X_X_X_X
X___X_X___X_X_X_X_X
X_X_X_XXX_X_X_X_X_X
X_X_X_____X_X___X__
XXXXXXXXXXXXXXXXXXX