
XXXXXXXXXXXXXXXXXXX
___X_XX___XX_X____X
X_X___X_____X___X_X
X_XXXXX_X_X_XXXXX_X
X________X________X
X_XXXXX_X_X_XXXXX_X
X_X___X_____X___X_X
X___X_XX___XX_X___X
XXXXXXXXXXXXXXXXXXX