
XXXXXXXXXXXX
X___X______X
X_X_X_XXXX_X
X_X_X____X_X
__X__XXX_X_X
XXXX_X___X_X
X__X___XXX_X
XX_X_XXX_X_X
X________X__
XXXXXX_XXX_X
X______X___X
XXXXXXXXXXXX