
XXXXXXXXX
X_X_X___X
X___X_XXX
XXX_X_X__
______X_X
XX_X_XX_X
X__X_X__X
XX_X_X__X
XXXXXXXXX